{
    "niveau": [
        [
            ["M", "P", "T", "R", "V", "T", "T", "V", "M", "R", "R", "M", "D", "V", "V", "R", "V"],
            ["M", "D", "T", "M", "M", "V", "R", "V", "V", "T", "R", "P", "R", "R", "P", "T", "M"],
            ["T", "R", "R", "T", "P", "T", "P", "D", "D", "R", "P", "P", "V", "M", "V", "T", "T"],
            ["R", "P", "M", "T", "D", "P", "T", "M", "T", "D", "P", "V", "M", "R", "D", "T", "V"],
            ["T", "V", "T", "D", "P", "M", "T", "V", "D", "D", "R", "D", "T", "M", "M", "M", "R"],
            ["R", "T", "D", "T", "M", "R", "R", "P", "R", "M", "M", "V", "M", "R", "P", "R", "T"],
            ["P", "M", "R", "V", "D", "V", "P", "D", "R", "T", "M", "R", "T", "V", "P", "M", "P"],
            ["V", "T", "P", "T", "T", "M", "V", "V", "V", "V", "T", "T", "P", "T", "V", "T", "R"],
            ["T", "V", "R", "D", "T", "D", "M", "V", "T", "V", "M", "M", "T", "M", "V", "M", "P"],
            ["R", "P", "M", "M", "P", "D", "T", "V", "V", "T", "P", "R", "T", "M", "T", "R", "P"],
            ["T", "P", "P", "T", "T", "D", "R", "P", "P", "R", "V", "R", "P", "R", "R", "R", "P"],
            ["D", "V", "T", "T", "D", "T", "M", "D", "D", "R", "P", "M", "D", "P", "R", "V", "R"],
            ["P", "R", "D", "V", "P", "T", "V", "D", "P", "V", "R", "D", "V", "M", "M", "M", "P"],
            ["R", "D", "R", "M", "V", "M", "R", "V", "V", "D", "V", "V", "D", "M", "R", "T", "P"],
            ["D", "M", "R", "R", "D", "T", "D", "M", "V", "D", "M", "V", "T", "T", "P", "P", "D"],
            ["D", "M", "P", "P", "D", "P", "P", "P", "R", "D", "T", "T", "R", "T", "M", "T", "P"],
            ["P", "T", "R", "D", "P", "P", "M", "M", "R", "P", "M", "R", "D", "D", "M", "M", "P"],
            ["P", "M", "P", "R", "R", "M", "D", "R", "D", "T", "R", "M", "M", "R", "T", "P", "D"],
            ["V", "D", "P", "M", "V", "D", "R", "T", "M", "V", "V", "R", "P", "R", "M", "D", "M"],
            ["D", "D", "T", "T", "V", "P", "P", "P", "R", "M", "P", "T", "T", "V", "P", "R", "V"],
            ["T", "P", "T", "T", "D", "V", "P", "M", "V", "D", "V", "R", "R", "P", "D", "D", "V"],
            ["P", "V", "P", "R", "M", "M", "M", "V", "M", "T", "P", "V", "T", "T", "M", "R", "T"],
            ["M", "D", "P", "V", "M", "T", "T", "P", "T", "M", "P", "P", "D", "M", "P", "T", "T"],
            ["R", "V", "M", "P", "R", "D", "V", "P", "T", "M", "M", "T", "V", "T", "M", "R", "P"],
            ["D", "R", "T", "V", "P", "M", "M", "D", "M", "V", "R", "D", "V", "M", "T", "P", "D"],
            ["M", "V", "R", "P", "V", "R", "P", "T", "D", "D", "P", "R", "P", "D", "R", "T", "T"],
            ["V", "M", "P", "P", "P", "M", "R", "M", "V", "V", "R", "M", "D", "V", "M", "M", "V"],
            ["M", "P", "V", "T", "D", "V", "T", "V", "D", "P", "T", "T", "T", "T", "M", "V", "V"],
            ["M", "M", "R", "M", "M", "P", "R", "P", "D", "D", "V", "P", "V", "R", "D", "R", "M"],
            ["D", "R", "D", "T", "P", "V", "M", "T", "D", "M", "M", "M", "T", "D", "P", "M", "V"],
            ["P", "D", "T", "R", "T", "V", "R", "M", "T", "D", "P", "P", "R", "D", "P", "T", "P"],
            ["V", "V", "V", "V", "T", "D", "T", "V", "V", "T", "R", "P", "M", "P", "D", "D", "R"],
            ["P", "D", "D", "P", "V", "T", "M", "P", "M", "V", "T", "P", "P", "M", "P", "M", "T"]
        ]
    ]
}