{
    "niveau": [
        [
            ["P", "T", "T", "T", "T", "T", "T", "T", "T", "T", "T", "T", "T", "T", "T", "T", "T"],
            ["T", "T", "T", "T", "T", "T", "T", "T", "T", "T", "T", "T", "T", "T", "T", "T", "T"],
            ["T", "T", "T", "T", "T", "T", "T", "T", "T", "R", "T", "T", "T", "T", "T", "T", "T"],
            ["T", "T", "T", "T", "T", "T", "T", "T", "T", "R", "T", "T", "T", "T", "T", "T", "T"],
            ["T", "T", "T", "T", "T", "T", "T", "T", "T", "R", "R", "T", "T", "T", "T", "T", "T"],
            ["T", "T", "T", "T", "T", "T", "D", "T", "T", "T", "T", "T", "T", "T", "T", "T", "T"],
            ["T", "T", "T", "T", "T", "T", "T", "T", "T", "T", "T", "T", "T", "T", "T", "T", "T"],
            ["T", "T", "T", "T", "T", "T", "T", "T", "T", "T", "T", "T", "T", "T", "T", "T", "T"],
            ["T", "T", "T", "T", "T", "T", "D", "T", "T", "R", "T", "T", "T", "T", "T", "T", "T"],
            ["T", "T", "T", "T", "T", "T", "R", "T", "R", "R", "T", "T", "T", "T", "T", "T", "T"],
            ["M", "M", "M", "M", "M", "M", "M", "M", "M", "T", "T", "T", "T", "T", "T", "T", "T"],
            ["T", "T", "T", "T", "T", "T", "T", "T", "T", "T", "T", "T", "T", "T", "T", "T", "T"],
            ["T", "T", "T", "T", "T", "T", "T", "T", "T", "T", "T", "T", "T", "T", "T", "T", "T"],
            ["T", "T", "T", "T", "T", "T", "T", "T", "T", "T", "T", "T", "T", "T", "T", "T", "T"],
            ["T", "T", "T", "T", "T", "T", "V", "T", "T", "T", "T", "T", "T", "T", "T", "T", "T"],
            ["T", "T", "T", "T", "T", "T", "T", "T", "R", "T", "T", "T", "T", "T", "T", "T", "T"],
            ["T", "T", "T", "T", "R", "T", "T", "R", "R", "R", "T", "T", "T", "T", "T", "T", "T"],
            ["T", "T", "T", "T", "T", "T", "T", "T", "T", "T", "T", "T", "T", "T", "T", "T", "T"],
            ["T", "T", "T", "T", "T", "T", "T", "D", "T", "T", "T", "T", "T", "T", "T", "T", "T"],
            ["T", "T", "T", "T", "T", "T", "T", "T", "T", "T", "T", "T", "T", "T", "T", "T", "T"],
            ["T", "T", "T", "T", "T", "T", "T", "T", "T", "T", "T", "T", "T", "T", "T", "T", "T"],
            ["T", "T", "T", "T", "T", "T", "T", "T", "M", "M", "M", "M", "M", "M", "M", "M", "M"],
            ["T", "T", "T", "T", "T", "T", "T", "T", "T", "T", "T", "T", "T", "T", "T", "T", "T"],
            ["T", "T", "T", "T", "T", "T", "T", "T", "T", "T", "T", "T", "T", "T", "T", "T", "T"],
            ["T", "T", "T", "R", "R", "T", "T", "T", "T", "T", "T", "T", "T", "T", "T", "T", "T"],
            ["T", "T", "T", "R", "D", "T", "T", "T", "T", "T", "T", "T", "T", "T", "T", "T", "T"],
            ["T", "T", "T", "T", "T", "T", "T", "T", "T", "T", "T", "T", "T", "T", "T", "T", "T"],
            ["T", "T", "T", "T", "T", "T", "T", "T", "T", "T", "T", "T", "T", "T", "T", "T", "T"],
            ["T", "T", "T", "T", "T", "T", "T", "T", "T", "T", "T", "T", "T", "T", "T", "T", "T"],
            ["T", "T", "T", "T", "T", "T", "T", "T", "T", "T", "T", "T", "T", "T", "T", "T", "T"],
            ["T", "T", "T", "T", "T", "T", "T", "T", "T", "T", "T", "T", "T", "T", "T", "T", "T"],
            ["T", "T", "T", "T", "T", "T", "T", "T", "T", "T", "T", "T", "T", "T", "T", "T", "T"],
            ["T", "T", "T", "T", "T", "T", "T", "T", "T", "T", "T", "T", "T", "T", "T", "T", "T"]
        ]
    ]
}