{
    "niveau": [
        {
        "level1" : [
            ["P", "T", "T", "T", "T", "T", "T", "T", "T", "T", "T", "T", "T", "T", "T", "T", "T"],
            ["T", "T", "T", "T", "T", "T", "T", "T", "T", "T", "T", "T", "T", "T", "T", "T", "T"],
            ["T", "T", "T", "T", "T", "T", "T", "T", "T", "R", "T", "T", "T", "T", "T", "T", "T"],
            ["T", "T", "T", "T", "T", "T", "T", "T", "T", "R", "T", "T", "T", "T", "T", "T", "T"],
            ["T", "T", "T", "T", "T", "T", "T", "T", "T", "R", "R", "T", "T", "T", "T", "T", "T"],
            ["T", "T", "T", "T", "T", "T", "D", "T", "T", "T", "T", "T", "T", "T", "T", "T", "T"],
            ["T", "T", "T", "T", "T", "T", "T", "T", "T", "T", "T", "T", "T", "T", "T", "T", "T"],
            ["T", "T", "T", "T", "T", "T", "T", "T", "T", "T", "T", "T", "T", "T", "T", "T", "T"],
            ["T", "T", "T", "T", "T", "T", "D", "T", "T", "R", "T", "T", "T", "T", "T", "T", "T"],
            ["T", "T", "T", "T", "T", "T", "R", "T", "R", "R", "T", "T", "T", "T", "T", "T", "T"],
            ["W", "W", "W", "W", "W", "W", "W", "W", "W", "T", "T", "T", "T", "T", "T", "T", "T"],
            ["T", "T", "T", "T", "T", "T", "T", "T", "T", "T", "T", "T", "T", "T", "T", "T", "T"],
            ["T", "T", "T", "T", "T", "T", "T", "T", "T", "T", "T", "T", "T", "T", "T", "T", "T"],
            ["T", "T", "T", "T", "T", "T", "T", "T", "T", "T", "T", "T", "T", "T", "T", "T", "T"],
            ["T", "T", "T", "T", "T", "T", "D", "T", "T", "T", "T", "T", "T", "T", "T", "T", "T"],
            ["T", "T", "T", "T", "T", "T", "T", "T", "R", "T", "T", "T", "T", "T", "T", "T", "T"],
            ["T", "T", "T", "T", "R", "T", "T", "R", "R", "R", "T", "T", "T", "T", "T", "T", "T"],
            ["T", "T", "T", "T", "T", "T", "T", "T", "T", "T", "T", "T", "T", "T", "T", "T", "T"],
            ["T", "T", "T", "T", "T", "T", "T", "D", "T", "T", "T", "T", "T", "T", "T", "T", "T"],
            ["T", "T", "T", "T", "T", "T", "T", "T", "T", "T", "T", "T", "T", "T", "T", "T", "T"],
            ["T", "T", "T", "T", "T", "T", "T", "T", "T", "T", "T", "T", "T", "T", "T", "T", "T"],
            ["T", "T", "T", "T", "T", "T", "T", "T", "W", "W", "W", "W", "W", "W", "W", "W", "W"],
            ["T", "T", "T", "T", "T", "T", "T", "T", "T", "T", "T", "T", "T", "T", "T", "T", "T"],
            ["T", "T", "T", "T", "T", "T", "T", "T", "T", "T", "T", "T", "T", "T", "T", "T", "T"],
            ["T", "T", "T", "R", "R", "T", "T", "T", "T", "T", "T", "T", "T", "T", "T", "T", "T"],
            ["T", "T", "T", "R", "D", "T", "T", "T", "T", "T", "T", "T", "T", "T", "T", "T", "T"],
            ["T", "T", "T", "T", "T", "T", "T", "T", "T", "T", "T", "T", "T", "T", "T", "T", "T"],
            ["T", "T", "T", "T", "T", "T", "T", "T", "T", "T", "T", "T", "T", "T", "T", "T", "T"],
            ["T", "T", "T", "T", "T", "T", "T", "T", "T", "T", "T", "T", "T", "T", "T", "T", "T"],
            ["T", "T", "T", "T", "T", "T", "T", "T", "T", "T", "T", "T", "T", "T", "T", "T", "T"],
            ["T", "T", "T", "T", "T", "T", "T", "T", "T", "T", "T", "T", "T", "T", "T", "T", "T"],
            ["T", "T", "T", "T", "T", "T", "T", "T", "T", "T", "T", "T", "T", "T", "T", "T", "T"],
            ["T", "T", "T", "T", "T", "T", "T", "T", "T", "T", "T", "T", "T", "T", "T", "T", "T"]
        ],
        "level2" : [
            ["P", "T", "T", "T", "T", "T", "T", "T", "T", "T", "T", "T", "T", "T", "T", "T", "T"],
            ["T", "T", "T", "T", "T", "T", "T", "T", "T", "T", "T", "T", "T", "T", "T", "T", "T"],
            ["T", "T", "T", "T", "T", "T", "T", "T", "T", "R", "T", "T", "T", "T", "T", "T", "T"],
            ["T", "T", "T", "T", "T", "T", "T", "T", "T", "R", "T", "T", "T", "T", "T", "T", "T"],
            ["T", "T", "T", "T", "T", "T", "T", "T", "T", "R", "R", "T", "T", "T", "T", "T", "T"],
            ["T", "T", "T", "T", "T", "T", "D", "T", "T", "T", "T", "T", "T", "T", "T", "T", "T"],
            ["T", "T", "T", "T", "T", "T", "T", "T", "T", "T", "T", "T", "T", "T", "T", "T", "T"],
            ["T", "T", "T", "T", "T", "T", "T", "T", "T", "T", "T", "T", "T", "T", "T", "T", "T"],
            ["T", "T", "T", "T", "T", "T", "D", "T", "T", "W", "T", "T", "T", "T", "T", "T", "T"],
            ["T", "T", "T", "T", "T", "T", "R", "T", "D", "T", "T", "T", "T", "T", "T", "T", "T"],
            ["W", "W", "W", "W", "W", "W", "W", "W", "W", "T", "W", "W", "W", "W", "W", "W", "W"],
            ["T", "T", "T", "T", "T", "T", "T", "T", "R", "T", "W", "T", "T", "T", "T", "T", "T"],
            ["T", "T", "T", "T", "T", "T", "T", "T", "T", "T", "T", "T", "T", "T", "T", "T", "T"],
            ["T", "T", "T", "T", "T", "T", "T", "T", "T", "T", "T", "T", "T", "T", "T", "T", "T"],
            ["T", "T", "T", "T", "T", "T", "D", "T", "T", "T", "T", "T", "T", "T", "T", "T", "T"],
            ["T", "T", "T", "T", "T", "T", "T", "T", "R", "T", "T", "T", "T", "T", "T", "T", "T"],
            ["T", "T", "T", "T", "R", "T", "T", "R", "R", "R", "T", "T", "T", "T", "T", "T", "T"],
            ["T", "T", "T", "T", "T", "T", "T", "T", "T", "T", "T", "T", "T", "T", "T", "T", "T"],
            ["T", "T", "T", "T", "T", "T", "T", "D", "T", "T", "T", "T", "T", "T", "T", "T", "T"],
            ["T", "T", "T", "T", "T", "T", "T", "T", "T", "T", "T", "T", "T", "T", "T", "T", "T"],
            ["T", "T", "T", "T", "T", "T", "T", "T", "T", "T", "T", "T", "T", "T", "T", "T", "T"],
            ["T", "T", "T", "T", "T", "T", "T", "T", "W", "W", "W", "W", "W", "W", "W", "W", "W"],
            ["T", "T", "T", "T", "T", "T", "T", "T", "T", "T", "T", "T", "T", "T", "T", "T", "T"],
            ["T", "T", "T", "T", "T", "T", "T", "T", "T", "T", "T", "T", "T", "T", "T", "T", "T"],
            ["T", "T", "T", "R", "R", "T", "T", "T", "T", "T", "T", "T", "T", "T", "T", "T", "T"],
            ["T", "T", "T", "R", "D", "T", "T", "T", "T", "T", "T", "T", "T", "T", "T", "T", "T"],
            ["T", "T", "T", "T", "T", "T", "T", "T", "T", "T", "T", "T", "T", "T", "T", "T", "T"],
            ["T", "T", "T", "T", "T", "T", "T", "T", "T", "T", "T", "T", "T", "T", "T", "T", "T"],
            ["T", "T", "T", "T", "T", "T", "T", "T", "T", "T", "T", "T", "T", "T", "T", "T", "T"],
            ["T", "T", "T", "T", "T", "T", "T", "T", "T", "T", "T", "T", "T", "T", "T", "T", "T"],
            ["T", "T", "T", "T", "T", "T", "T", "T", "T", "T", "T", "T", "T", "T", "T", "T", "T"],
            ["T", "T", "T", "T", "T", "T", "T", "T", "T", "T", "T", "T", "T", "T", "T", "T", "T"],
            ["T", "T", "T", "T", "T", "T", "T", "T", "T", "T", "T", "T", "T", "T", "T", "T", "T"]
        ],
        "level3" : [
            ["P", "T", "T", "T", "T", "T", "T", "T", "T", "T", "T", "T", "T", "T", "T", "T", "T"],
            ["T", "T", "T", "T", "T", "T", "T", "T", "T", "T", "T", "T", "T", "T", "T", "T", "T"],
            ["T", "T", "T", "T", "T", "T", "T", "T", "T", "R", "T", "T", "T", "T", "T", "T", "T"],
            ["T", "T", "T", "T", "T", "T", "T", "T", "T", "R", "T", "T", "T", "T", "T", "T", "T"],
            ["T", "T", "T", "T", "T", "T", "T", "T", "T", "R", "R", "T", "T", "T", "T", "T", "T"],
            ["T", "T", "T", "T", "T", "T", "D", "T", "T", "T", "T", "T", "T", "T", "T", "T", "T"],
            ["T", "T", "T", "T", "T", "T", "T", "T", "T", "T", "T", "T", "T", "T", "T", "T", "T"],
            ["T", "T", "T", "T", "T", "T", "T", "T", "T", "T", "T", "T", "T", "T", "T", "T", "T"],
            ["T", "T", "T", "T", "T", "T", "D", "T", "T", "R", "T", "T", "T", "T", "T", "T", "T"],
            ["T", "T", "T", "T", "T", "T", "R", "T", "R", "R", "T", "T", "T", "T", "T", "T", "T"],
            ["W", "W", "W", "W", "W", "W", "W", "W", "W", "T", "T", "T", "T", "T", "T", "T", "T"],
            ["T", "T", "T", "T", "T", "T", "T", "T", "T", "T", "T", "T", "T", "T", "T", "T", "T"],
            ["T", "T", "T", "T", "T", "T", "T", "T", "T", "T", "T", "T", "T", "T", "T", "T", "T"],
            ["T", "T", "T", "T", "T", "T", "T", "T", "T", "T", "T", "T", "T", "T", "T", "T", "T"],
            ["T", "T", "T", "T", "T", "T", "D", "T", "T", "T", "T", "T", "T", "T", "T", "T", "T"],
            ["T", "T", "T", "T", "T", "T", "T", "T", "R", "T", "T", "T", "T", "T", "T", "T", "T"],
            ["T", "T", "T", "T", "R", "T", "T", "R", "R", "R", "T", "T", "T", "T", "T", "T", "T"],
            ["T", "T", "T", "T", "T", "T", "T", "T", "T", "T", "T", "T", "T", "T", "T", "T", "T"],
            ["T", "T", "T", "T", "T", "T", "T", "D", "T", "T", "T", "T", "T", "T", "T", "T", "T"],
            ["T", "T", "T", "T", "T", "T", "T", "T", "T", "T", "T", "T", "T", "T", "T", "T", "T"],
            ["T", "T", "T", "T", "T", "T", "T", "T", "T", "T", "T", "T", "T", "T", "T", "T", "T"],
            ["T", "T", "T", "T", "T", "T", "T", "T", "W", "W", "W", "W", "W", "W", "W", "W", "W"],
            ["T", "T", "T", "T", "T", "T", "T", "T", "T", "T", "T", "T", "T", "T", "T", "T", "T"],
            ["T", "T", "T", "T", "T", "T", "T", "T", "T", "T", "T", "T", "T", "T", "T", "T", "T"],
            ["T", "T", "T", "R", "R", "T", "T", "T", "T", "T", "T", "T", "T", "T", "T", "T", "T"],
            ["T", "T", "T", "R", "D", "T", "T", "T", "T", "T", "T", "T", "T", "T", "T", "T", "T"],
            ["T", "T", "T", "T", "T", "T", "T", "T", "T", "T", "T", "T", "T", "T", "T", "T", "T"],
            ["T", "W", "W", "W", "W", "W", "W", "W", "W", "W", "W", "W", "W", "W", "W", "W", "W"],
            ["T", "R", "D", "R", "T", "T", "T", "T", "T", "T", "T", "T", "T", "T", "T", "T", "T"],
            ["T", "W", "T", "R", "T", "T", "T", "T", "T", "T", "T", "T", "T", "T", "T", "T", "T"],
            ["T", "T", "T", "T", "T", "T", "T", "T", "T", "T", "T", "T", "T", "T", "T", "T", "T"],
            ["T", "T", "T", "T", "T", "T", "T", "T", "T", "T", "T", "T", "T", "T", "T", "T", "T"],
            ["T", "T", "T", "T", "T", "T", "T", "T", "T", "T", "T", "T", "T", "T", "T", "T", "T"]
        ]
    }
    ]
}